.....#........
......##......
...##...#.....
..#..##..#....
..#....#..#...
..#..#..#..#..
...#..#.#..#..
....#..#..#...
.....#...#....
......###.....