.....#........
......##......
...##...#.....
..#..##..#....
..#....#..#...
..#..#.M#..#..
...#..#X#..#..
....#..#..#...
.....#...#....
......###.....