.##########..###########
.#.....M..#..#.........#
.#......#.#..#.XM......#
.#......#.#..#.........#
........#.#..#.........#
#########.#..#.........#
........#.#..#.........#
........#.############.#
........#..............#
########################