.##########..###########
.#........#..#.........#
.#......#.#..#.X.......#
.#......#.#..#.........#
........#.#..#.........#
#########.#..#.........#
........#.#..#.........#
........#.############.#
........#..............#
########################