..............
..............
..............
....##..##....
....#....#....
....#.$$.#....
....######....
..............
..............
..............