..............
..............
..............
....##MM##....
....#....#....
....#.$$.#....
....######....
..............
..............
..............